####################
#o...#........#...o#
#.##.#.######.# ##.#
#.#   .      .   #.#
#.# ## ##  ## ## #.#
#.     # ^^ #     .#
#.# ## ###### ## #.#
#.#   .  *   .   #.#
#.## #.######.# ##.#
#o...#........#...o#
####################