###################
#........#........#
#o##.###.#.###.##o#
#........#........#
#.##.#.#####.#.##.#
#....#...#...#....#
####.### # ###.####
   #.#   ^   #.#
####.# ## ## #.####
    .  # ^ #  .
####.# ##### #.####
   #.#       #.#
####.# ##### #.####
#........#........#
#.##.###.#.###.##.#
#o.#.....*.....#.o#
##.#.#.#####.#.#.##
#....#...#...#....#
#.######.#.######.#
#.................#
###################