#####################
#......# ^ ^ #......#
#.##...##   ##...##.#
#.#o.#.........#.o#.#
#.##.#.#######.#.##.#
#........ * ........#
#####################